0000000000
0111111110
0111111110
0110000110
0111110110
0111110110
0111110110
0111111110
0111111110
0000000000